Team Abbreviations
---------------------------------
crd - Arizona Cardinals
atl - Atlanta Falcons
rav - Baltimore Ravens
buf - Buffalo Bills
car - Carolina Panthers
chi - Chicago Bears
cin - Cincinatti Bengals
cle - Cleveland Browns
dal - Dallas Cowboys
den - Denver Broncos
det - Detroit Lions
gnb - Green Bay Packers
htx - Houston Texans
clt - Indianapolis Colts
jax - Jack
kan - Kansas City Chiefs
rai - Las Vegas Raiders
sdg - San Diego Chargers
ram - Los Angelese Rams
mia - Miami Dolphins
min - Minnesota Vikings
nwe - New England Patriots
nor - New England Patriots
nyg - New York Giants
nyj - New York Jets
phi - Philadelphia Eagles
pit - Pittsburgh Steelers
sfo - San Francisco 49ers
sea - Seattle Seahawks
tam - Tampa Bay Buccaneers
oti - Tennessee Titans
was - Washington Commanders
---------------------------------